WWWWWWWWWWWWWWWWWWWWWWWWWWWWWWWW
W..............WW..............W
W..............WW..............W
W..............WW..............W
W..............WW..............W
W..............WW..............W
W..............WW..............W
W..............WW..............W
W..............WW..............W
W..............WW..............W
WP..B..........WW..............W
W..............WW.............MW
W..............WW..............W
W..............WW..............W
W..............WW..............W
W..............WW..............W
W..............WW..............W
W..............WW..............W
W..............WW..............W
W..............WW..............W
W..............WW..............W
W..............WW..............W
W..............WW..............W
WWWWWWWWWWWWWWWWWWWWWWWWWWWWWWWW