WWWWWWWWWWWWWWWWWWWWWWWWWWWWWWWW
W..............................W
W..............................W
W..............................W
W..............................W
W..............................W
W..............................W
W..............................W
W..............................W
W..............................W
W..............................W
W..............................W
W..............................W
W..............................W
W.......T.......Q..............W
W..............................W
W..............................W
W..............................W
W..............................W
W..............................W
W..............................W
W..............................W
W..............................W
WWWWWWWWWWWWWWWWWWWWWWWWWWWWWWWW